________________________________________________________________________________________________________________________
__,,,___________________________________________________________________________________________________________________
___,,,,,,_______________________________________________________________________________________________________________
__,,___,,,,,_______,,___________________________________________________________________________________________________
__,__,,,,,,,,,__,,,_____________________________________________________________________________________________________
_,,____,^^,,,___,,,,,,,,,_______________________________________________________________________________________________
_______,,^^^,,,,,,,_____________________________________________________________________________________________________
___,,,,,,^^^^,,,,_,,,,,,,,,,____________________________________________________________________________________________
__,,_,,,,,^^^^,,,,,,,,,,,_______________________________________________________________________________________________
_______,,,,^^,,,,,,,__,,,,,,,,,,________________________________________________________________________________________
_________,,,^^^,,,,______,,,,,,,,,,_____________________________________________________________________________________
______,,,^^,^^^,,,,,,,,___,,,,,,,___________,___________________________________________________________________________
________,,,,,,^^^^,,,,,,,,,,,,_____________,,,__________________________________________________________________________
_____,,,,,,,,,,,^^^^^,,,,,,,,,,,,_______,,,,____________________________________________________________________________
_____,,,,,,,,,,,^^^,,,,,,,,,,,,,,,,,,,,,,,,,,,,,,_______________________________________________________________________
___,,,,,,,,,,,,^^,,,,,,,,,,,,,,,,,,,,,,,,,,_____________________________________________________________________________
________,,,__,,,,,,,,,,,,,,,,,,,,,,,,,,_________________________________________________________________________________
______________,,,,,,,,,,,,__,,,,,,,,,___________________________________________________________________________________
____________,,,,_,,,,,,___,,,,,,,,,_____________________________________________________________________________________
______________,,_,,,______,,,,__________________________________________________________________________________________
_________,,,,,,_________________________________________________________________________________________________________
____________,,__________________________________________________________________________________________________________
________________________________________________________________________________________________________________________
________________________________________________________________________________________________________________________
________________________________________________________________________________________________________________________
________________________________________________________________________________________________________________________
________________________________________________________________________________________________________________________
________________________________________________________________________________________________________________________
________________________________________________________________________________________________________________________
________________________________________________________________________________________________________________________
________________________________________________________________________________________________________________________
________________________________________________________________________________________________________________________
________________________________________________________________________________________________________________________
________________________________________________________________________________________________________________________
________________________________________________________________________________________________________________________
________________________________________________________________________________________________________________________
________________________________________________________________________________________________________________________
________________________________________________________________________________________________________________________
________________________________________________________________________________________________________________________
________________________________________________________________________________________________________________________
________________________________________________________________________________________________________________________
________________________________________________________________________________________________________________________
________________________________________________________________________________________________________________________
