__________________________,,,,__________________________________________________________________________________________
__,,,______________________,,___________________________________________________________________________________________
___,,,,,,_______________________________________________________________________________________________________________
__,,___,,,,,_______,,___________________________________________________________________________________________________
_____,,,,,,,,,__,,,___________,,________________________________________________________________________________________
_______,^^,,,___,,,,,,,,,_______________________________________________________________________________________________
_______,,^^^,,,,,,,_____________________________________________________________________________________________________
___,,,,,,^^^^,,!,_,,,,,,,,,,____________________________________________________________________________________________
__,,_,,,,,^^^^,,,,,,,,,,,_______________________________________________________________________________________________
_______,,,,^^!!,,,,,__,,,,,,,,,,________________________________________________________________________________________
_________,,!^^^!!,,______,,,,,,,,,,_____________________________________________________________________________________
______,,,^^,^^^!!!!,,,,___,,,,,,,___________,___________________________________________________________________________
________,,,,!!^^^^!!!!,,,,,,,,,,___________,,,__________________________________________________________________________
_____,,,,,,!!!!!^^^^^!!!,,,,,,,,,,,_____,,,,____________________________________________________________________________
_____,,,,,,,,!!!^^^!!!!,,,,,,,,,,,,,,,,,,,,,,,,,,_______________________________________________________________________
___,,,,,,,,,,,!^^!!!!,!!,,,,,,,,,!!,,,,,,,,_____________________________________________________________________________
________,,,__,!!!!,!,,,,,,,,,,,,!!!!!,,_________________________________________________________________________________
______________,,!!,,,,,,,,__,,,,,,!,,___________________________________________________________________________________
____________,,,,_,,,,,,___,,,,,,,,,_____________________________________________________________________________________
______________,,_,,,______,,,,__________________________________________________________________________________________
_________,,,,,,_________________________________________________________________________________________________________
____________,,__________________________________________________________________________________________________________
________________________________________________________________________________________________________________________
________________________________________________________________________________________________________________________
________________________________________________________________________________________________________________________
________________________________________________________________________________________________________________________
________________________________________________________________________________________________________________________
________________________________________________________________________________________________________________________
________________________________________________________________________________________________________________________
________________________________________________________________________________________________________________________
________________________________________________________________________________________________________________________
________________________________________________________________________________________________________________________
________________________________________________________________________________________________________________________
________________________________________________________________________________________________________________________
________________________________________________________________________________________________________________________
________________________________________________________________________________________________________________________
________________________________________________________________________________________________________________________
________________________________________________________________________________________________________________________
________________________________________________________________________________________________________________________
________________________________________________________________________________________________________________________
________________________________________________________________________________________________________________________
________________________________________________________________________________________________________________________
________________________________________________________________________________________________________________________
