````````````````````````````````````````````````````````````````````````````````````````````````````````````````````````
````````````````````````````````````````==================``````````````````````````````````````````````````````````````
````````````````````````````````````````=```=``$``=``````=``````==========``````````````````````````````````````````````
````````````````````````````````````````=```=`````=``````=``````=````````=``````````````````````````````````````````````
````````````````````````````````````````=```=`````=``````=``````=````U```=``````````````````````````````````````````````
````````````````````````````````````````=```===[===``````=``````=$```````=========``````````````````````````````````````
````````````````````````````````````````=````````````````=``````=````````=````````=`````````````````````````````````````
`````````````````````````````````========````````````````========````````[`````````=````````````````````````````````````
`````````````````````````````````=``$$``=```````````````````````==========``````````=```````````````````````````````````
`````````````````````````````````=``````=````````````````````````````````=====[[======``````````````````````````````````
`````````````````````````````````===[====````````````````````````````````````````````=``````````````````````````````````
`````````````````````````````````=``````[````````````````````````````````````````````=``````````````````````````````````
```````````````````````````=========[====````````````````````````````````````````````=``````````````````````````````````
```````````````````````````=````````````=````````````````````````````````````````````=``````````````````````````````````
```````````````````````````=````````````=`````=======================[[====``````````=``````````````````````````````````
`````````````=================================``````=```````````=`````````=``````````=``````````````````````````````````
`````````````=``````````=```````=```````````=```````[```````````=`````````============``````````````````````````````````
`````````````=$`````````[```````[``````````=````````=``````$````[`````````=``````````=``````````````````````````````````
`````````````============```$```=`````=====================================``````````=``````````````````````````````````
`````````````=````=`````===============`````[```````[`````````````````````[``````````=``````````````````````````````````
`````````````=````=`````[`````=```````=````================================``````````=``````````````````````````````````
`````````````=````=`````=`````[```````=````=```$$```=``````$````[`````````=``````````=``````````````````````````````````
````````````======================[====````=````````[```````````=`````````======[=====``````````````````````````````````
````````````=!`````[``=``=````=```````==[[==````````=```````````=````````````````````===========````````````````````````
````````````========``[``[````=========````====[[================``````````````````````````````=````````````````````````
````````````========``[``[````[````````````[```````````[````````=``````````````````````````````=````````````````````````
````````````=$`````[``=``=````===[======================````````=``````````````````````````````=````````````````````````
````````````===[[=============``````=``````[```[```=```=````````=``````````````````````````````=````````````````````````
`````````````````````=```````=D`````[``````=====```[```=````````=```````````````````````========````````````````````````
`````````````````````=```````[``````========~~~=```=```=````````[```````````````````````[`````$=````````````````````````
`````````````````````=``$````===[======`$$`=~~~[`=[=====````````=```````````````````````========````````````````````````
`````````````````````=```````[````````=`~~`=~~~==``````=````````=```````````````````````[``````=````````````````````````
`````````````````````=========````````==[[=========[[======[=====```````````````````````========````````````````````````
`````````````````````````````====[[====``````=`````=````````````=======================````````=````````````````````````
`````````````````````````````=```````[```````[`````[````````````=`````=````=``=```````=````````=````````````````````````
`````````````````````````````=```````=```````=`````[````````````=`````[````=``=```````=````````=````````````````````````
`````````````````````````````============[====`````=````````````=`````=````[``=```````=````````=````````````````````````
```````````````````````=========``````=`````====[[================[======[==``[```````=```````=`````````````````````````
```````````````````````=`!~~```=``````[`````=``````=```=````[`````````=````======[[====``````=``````````````````````````
```````````````````````=`!~~```[``````=`````[``````[```[````=`````````=$```=``````````=`````=```````````````````````````
``````````````````````=``!~~```====[=====[===``$$``=```===========[[====[========[[=========````````````````````````````
`````````````````````=$``!~~```=``````[`````============````````````````=``````[````=```````````````````````````````````
````````````````````============``````=`````=```````````````````````````=``````[````=```````````````````````````````````
````````````````````````````````=======[=====````````=====[===========[==============```````````````````````````````````
`````````````````````````````````=~~~~~~~~~~~=====[=======````````=````````=````````=```````````````````````````````````
``````````````````````````````````=``````````=````````=````$$````=````~~```[``````$=````````````````````````````````````
```````````````````````````````````===============[================================`````````````````````````````````````
```````````````````````````````````````````````=$```$=``````````````````````````````````````````````````````````````````
```````````````````````````````````````````````=======``````````````````````````````````````````````````````````````````
````````````````````````````````````````````````````````````````````````````````````````````````````````````````````````
````````````````````````````````````````````````````````````````````````````````````````````````````````````````````````
````````````````````````````````````````````````````````````````````````````````````````````````````````````````````````
````````````````````````````````````````````````````````````````````````````````````````````````````````````````````````
````````````````````````````````````````````````````````````````````````````````````````````````````````````````````````
````````````````````````````````````````````````````````````````````````````````````````````````````````````````````````