````````````````````````````````````````````````````````````````````````````````````````````````````````````````````````
````````````````````````````````````````````````````````````````````````````````````````````````````````````````````````
````````````````````````````````````````````````````````````````````````````````````````````````````````````````````````
````````````````````````````````````````````````````````````````````````````````````````````````````````````````````````
``````==========================================================================================================````````
``````============````=`````=```````````=``````````````````````````````````````````````````````````````````````=````````
``````=``=```````[````==[====```````````=``````````````````````````````````````````````````````````````````````=````````
``````=```=[==```=``````````[```````````=``````````````````````````````````````````````````````````````````````=````````
``````=``````=====`````======```````````=``````````````````````````````````````````````````````````````````````=````````
``````=``````````=`````[````=```````````=``````````````````````````````````````````````````````````````````````=````````
``````=====[=========[=============[=====``````````````````````````````````````````````````````````````````````=````````
``````=``````````=``````````=```````````=``````````````````````````````````````````````````````````````````````=````````
``````=``````````=``````````[```````````=``````````````````````````````````````````````````````````````````````=````````
``````=``````````=``````````=```````````=``````````````````````````````````````````````````````````````````````=````````
``````=``````````=``````````=```````````=``````````````````````````````````````````````````````````````````````=````````
``````=====[=============================``````````````````````````````````````````````````````````````````````=````````
``````=````````=````=````=````````[``$``=======================================````````````````````````````````=````````
``````=````````[````=````=````````=`````=````=````````=`````=````=````````````=````````````````````````````````=````````
``````=````````[````==[[==````````=======````=````````=`````=````=`,,,,,,,,,,`=````````````````````````````````=````````
``````=````````=``````````````````[````$==[===````````[`````==[===`,~~~~~~~~,`=````````````````````````````````=````````
``````=================[[================`````````````=``````````=`,~~~~~~~~,`=````````````````````````````````=````````
``````=``````=````````````````=`````````=======[==================`,~~~#~~~~,`=````````````````````````````````=````````
``````=``````[````````````````[`````````=`````````````=````=`````=`,~~~#~~~~,`=````````````````````````````````=````````
``````==========[==============`````````=`````````````=````=`````=`,,,,,,,,,,`=````````````````````````````````=````````
``````=``````[````````````````[`````````=`````````````==[===`````=````````````=````````````````````````````````=````````
``````=``````=````````````````=`````````[`````````````=``````````=````````````=````````````````````````````````=````````
``````==================================================================[======````````````````````````````````=````````
``````=`,!!!,,``=`````=`````===================````````````````````````````````````````````````````````````````=````````
``````=`````````=`````[`````=D,[``%`````=````$======```````````````````````````````````````````````````````````=````````
``````=====[=====`````=======,,=````````[``````````=```````````````````````````````````````````````````````````=````````
``````=`````````===[===`````=============``````````[```````````````````````````````````````````````````````````=````````
``````=`````````=`````[`````=```=`$$=```============```````````````````````````````````````````````````````````=````````
``````======````===========`[```=[===```=``````````=```````````````````````````````````````````````````````````=````````
``````=````[`````=```$````=`[```````````[``````````=```````````````````````````````````````````````````````````=````````
``````=````=`````[````````=`=```````````=``````````=```````````````````````````````````````````````````````````=````````
``````==================[===========================```````````````````````````````````````````````````````````=````````
``````=````=```=``````=```````[`````=``````````````````````````````````````````````````````````````````````````=````````
``````=````[````[`````=````````=```[`=======```````````````````````````````````````````````````````````````````=````````
``````=````=````==````====[[=====`=````````=```````````````````````````````````````````````````````````````````=````````
``````========[==`=```=``````````===========```````````````````````````````````````````````````````````````````=````````
``````=````````````=``=`````````=``````````````````````````````````````````````````````````````````````````````=````````
``````==========================```````````````````````````````````````````````````````````````````````````````=````````
``````=````````````````````````````````````````````````````````````````````````````````````````````````````````=````````
``````=````````````````````````````````````````````````````````````````````````````````````````````````````````=````````
``````=````````````````````````````````````````````````````````````````````````````````````````````````````````=````````
``````=````````````````````````````````````````````````````````````````````````````````````````````````````````=````````
``````=````````````````````````````````````````````````````````````````````````````````````````````````````````=````````
``````=````````````````````````````````````````````````````````````````````````````````````````````````````````=````````
``````=````````````````````````````````````````````````````````````````````````````````````````````````````````=````````
``````=````````````````````````````````````````````````````````````````````````````````````````````````````````=````````
``````=================================================[[[======================================================````````
``````=```````````````````````````````````````````````````=```````=````[```````````````````````````````````````=````````
``````=```````````````````````````````````````````````````[```````==[===========================================````````
``````=```````````````````````````````````````````````````[````````````=========================================````````
``````=```````````````````````````````````````````````````=````````````[```````````````````````````````````````=````````
``````==========================================================================================================````````
````````````````````````````````````````````````````````````````````````````````````````````````````````````````````````
````````````````````````````````````````````````````````````````````````````````````````````````````````````````````````
````````````````````````````````````````````````````````````````````````````````````````````````````````````````````````
````````````````````````````````````````````````````````````````````````````````````````````````````````````````````````
