========================================================================================================================
==````[````=````=````=````=````=````=````=````=````=````==````=````=````=`````=````=````=````=````=````=````=````[````==
=`=````=````=````=````=````[````=````=````=````=````=```==```=````=````=`````=````=````=````=````=````=````=````=````=`=
=``=````=````=````=````=````=````=````=````=````=````=``==``=````=````=`````=````=````=````=````=````=````=````=````=``=
=```=````=````=````=````=````=````=````=````=````=````=$==$=````=````=`````=````=````=````=````=````=````=````=````=```=
=````=````=````=````[````=````=````=````=````=````=````====````=````=`````=````=````=````=````=````=````=````=````=````=
==````=````=````=````=````=````=````=````=````=````=````==````=````=`````=````=````=````=````=````=````=````=````=````==
=`=````=````=````=````=````=````=````=````=````=````=```==```=````=`````=````=````=````=````=````=````=````=````=````=`=
=``=````=````=````=````=````=````=````=````=````=````=``[[``=````=`````=````=````=````=````=````=````=````=````=````=``=
=```=````=````=````=````=````=````=````=````=````=````=`==`=````=`````=````=````=````=````=````=````=````=````=````=```=
=````=````=````=````=````=````=````=````=````=````=````====````=`````=````=````=````=````=````=````=````=````=````=````=
=`````=````[````=````=````=````=````=````=````=````=````==````=`````=````=````=````=````=````=````=````=````[````=`````=
=``````=````=````=````=````=````=````=````=````=````=```==```=`````=````=````=````=````=````=````=````=````=````=``````=
========[=====`~~~=````[````=````=````=````=````=````=``==``=`````=````=````=````=````=````=````=````=````=====[========
=~~~~~~=``````=$$$$=````=````=````[````=````=````=````=`==`=`````=````=````=````=````=````=````=````=`%$`=``````=~~~~~~=
========```````======````=````=````=````=````=````=````====`````=````=````=````=````=````=````=````======```````========
==============[=========================================================================================================
=`````````````````````````````````````````````````[```$====%```[````````````````````````=``==``==``[```=```[```=```[```=
=``````````````````````````````````````````````````=``=`==`=``=`````````````````````````=``[[``==``=```=```=```=```=```=
=```````````````````````````````````````````````````==``==``==``````````````````````````=``==``==``=```[```=```[```=```=
=```````````````````````````````````````````````````=```==```=``````````````````````````=``===[===========[===[=========
=``````````````````````````````````````````````````=````==````=`````````````````````````=``[[``==``=```[```=```=```[```=
=`````````````````````````````````````````````````=`````[[`````=````````````````````````=``==``[[``[```=```[```[```=```=
=````````````````````````````````````````````````=``````[[``````=```````````````````````=``==========[===[=======[==[===
=```````````````````````````````````````````````=```````==```````=``````````````````````[``[[``==``=```[```[```[```=```=
=``````````````````````````````````````````````=````````==````````=`````````````````````=``==``==``[```=```=```=```[```=
=`````````````````````````````````````````````[`````````==`````````[````````````````````=``======[=======[===[===[====[=
=````````````````````````````````````````````=``````````==``````````=```````````````````=``==``==``=```=```=```=```=```=
=```````````````````````````````````````````=```````````==```````````=``````````````````=``==``==``[```=```=```=```=```=
======================================================================================================[=================
=```````````````````````````````````````````=````````=$`==%`=````````=``````````````````=``==``=```=```=```=```=```=```=
=````````````````````````````````````````````=````````[`==`[````````=```````````````````=``==``=```=```=```=```=```=```=
=`````````````````````````````````````````````[````````====````````[````````````````````================================
=``````````````````````````````````````````````=````````==````````=`````````````````````=``==``=```=```=```=```=```=```=
=```````````````````````````````````````````````=```````[[```````=``````````````````````=``==``=```=```=```=```=```=```=
=````````````````````````````````````````````````=``````[[``````=```````````````````````================================
=`````````````````````````````````````````````````=`````==`````=````````````````````````=``==``=```=```=```=```=```=```=
=``````````````````````````````````````````````````=````==````=`````````````````````````=``==``=```=```=```=```=```=```=
=```````````````````````````````````````````````````=```==```=``````````````````````````================================
=````````````````````````````````````````````````````=``==``=```````````````````````````=``==``=```=```=```=```=```=```=
=`````````````````````````````````````````````````````======````````````````````````````=``==``=```=```=```=```=```=```=
========================================================================================================================
=`````````````=`````````````````````````````````````````==```````````````````````````````````````````````=`````````````=
=````````````=``````````````````````````````````````````==````````````````````````````````````````````````=````````````=
=```````````=```````````````````````````````````````````==`````````````````````````````````````````````````=```````````=
=``````````=````````````````````````````````````````````==``````````````````````````````````````````````````=``````````=
=`````````=`````````````````````````````````````````````==```````````````````````````````````````````````````=`````````=
=````````=``````````````````````````````````````````````==````````````````````````````````````````````````````=````````=
=```````=```````````````````````````````````````````````[[`````````````````````````````````````````````````````=```````=
=``````=````````````````````````````````````````````````==``````````````````````````````````````````````````````=``````=
=`````=`````````````````````````````````````````````````==```````````````````````````````````````````````````````=`````=
=````=``````````````````````````````````````````````````==````````````````````````````````````````````````````````=````=
=```=```````````````````````````````````````````````````==`````````````````````````````````````````````````````````=```=
=``=````````````````````````````````````````````````````==``````````````````````````````````````````````````````````=``=
=`=`````````````````````````````````````````````````````==```````````````````````````````````````````````````````````=`=
==``````````````````````````````````````````````````````==````````````````````````````````````````````````````````````==
========================================================================================================================
````````````````````````````````````````````````````````````````````````````````````````````````````````````````````````
````````````````````````````````````````````````````````````````````````````````````````````````````````````````````````
