``````````````````````````````````````````````````````==========````````````````````````````````````````````````````````
=``D````````````````````````````````````````=========='''$$$'''=`````````````````================```````````````````````
=```````````````````````````````````````````=````````='''''''''=`````````````````=```````$``````=```````````````````````
=`````````````````````````===================````````='''''''''=`````````````````=``````````````=```````````````````````
=`````````````````````````=````````````=````=````````['''''''''=`````````````````=``````````````=```````````````````````
=``````~~~````````````````=````````````=````=````````='''''''''=`````````````````=``````````````=```````````````````````
=```````~~````````````````=````````````=````[````````=====[[====`````````````============[=========`````````````````````
=`````````````````````````=````````````=````=````````=`````````=`````````````=````````````````````=`````````````````````
=`````````````````````````=````````````[````=````````=`````````===============````````````````````=`````````````````````
=`````````````````````````==========[=================````````$=`````````````=````````````````````=`````````````````````
=````````````````````````````=```````````=```````````=`````````=`````````````=````````````````````=`````````````````````
=````````````````````````````=```````````[````````````[````````=`````````````=========[============`````````````````````
=`````````````````````````============================`````````=[=============````````````$`````==================``````
=`````````````````````````=``````````$```````=```````=`````````=`````````````[``````````````````[````````````````=``````
=`````````````````````````=``````````````````=```````=====[=====`````````````=``````````````````=````````````````=``````
=`````````````````````````=``````````````````[```````[`````````===========================================[=[=====``````
=`````````````````````````=``````````````````=```````=````~~```=``````=`````````=```````=``````````````=```=````$=``````
======================================================`````````=``````=`````````=```````[``````````````=```=`````=``````
```````````````````=```````````````````````````````````````````=``````=`````````=```````=``````````````=```=`````=``````
```````````````````=```````````````````````````````````````````=``````=`````````[```````=``````````````=```=`````=``````
`````````=====================`````==========[===========[=============`````````=```````======[[==================``````
`````````=``````=````````````=`````=``````=```````$`````=`````````````=`````````=```````[``````````````=`````````=``````
`````````=$`````[````````````=`````=``````=`````````````=````~~~~~````===========```````=``````````````=`````````=``````
``````========================`````=``````=`````````````=`````````````=`````````====[========[===``````[`````````=``````
``````=`````````=```=````````=`````=``````=`````````````=======[[======`````````=```````=```````==================``````
``````=====[=====```=````````============================`````````````=`````````=```````=``````````=```````=````````````
``````=`````````[```=``````````````=``````````=`````````[`````````````[`````````=```````[``````````=```````=````````````
``````=`````````=```=``````````````[``````````=`````````======[========`````````[```````=``````````[```````=````````````
``````=`````````=```=====[==========``````````=`````````=`$```````````=`````````=```````=``````````=```````=````````````
``````======[====```=``````````````============`````````========[========[==================================````````````
``````=`````````=```=`````````````U=``````````=`````````=,,,,,,,,,,,,,,=```````=`````````=``````````````=```````````````
==================[[=``````````````=``````````=`````````=~~~~~,,,,~~~~~=```````=`````````=``````````````=```````````````
=~~~~~~~~~~,,,,=````=========[=====================[[====~~~~~,,,,~~~~~[```````[`````````=``````````````=```````````````
=,,~~~~~~,,,,,,[`````=`````=````$``````=````````````````=,,,,,,,,,,,,,,=```$```=`````````========[[======```````````````
=,$,~,,,,,,,,,,=`````=`````[```````````[````````````````=======[==========================``````````````=```````````````
=,,~~~~~,,,,,,,=`````=`````=```````````==================`````````````````~[~``$$$$``````=``````````````=```````````````
================`````[`````=```````````[````````=```````=`````````````````~[~```````````~[``````````````=```````````````
```````````````===[===`````=```````````=````````=```````=`==========[=====================================``````````````
```````````````=`````=`````=============````````[```````=````````````=``````````````````````````````````````````````````
```````````````=``$``=`````````````````=````````=```````[````````````=``````````````````````````````````````````````````
```````````````=======================================================``````````````````````````````````````````````````
