````````````````````````````````````````````````````````````````````````````````````````````````````````````````````````
````````````````````````````````````````==================``````````````````````````````````````````````````````````````
````````````````````````````````````````=```=``$``=``````=``````==========``````````````````````````````````````````````
````````````````````````````````````````=```=`````=``````=``````=````````=``````````````````````````````````````````````
````````````````````````````````````````=```=`````=``````=``````=````U```=``````````````````````````````````````````````
````````````````````````````````````````=```===[===``````=``````=$```````=========``````````````````````````````````````
````````````````````````````````````````=````````````````=``````=````````=````````=`````````````````````````````````````
`````````````````````````````````========````````````````========````````[`````````=````````````````````````````````````
`````````````````````````````````=``````````````````````````````==========``````````=```````````````````````````````````
`````````````````````````````````=```````````````````````````````````````=====[[======``````````````````````````````````
`````````````````````````````````=```````````````````````````````````````````````````=``````````````````````````````````
`````````````````````````````````=```````````````````````````````````````````````````=``````````````````````````````````
```````````````````````````=======```````````````````````````````````````````````````=``````````````````````````````````
```````````````````````````=`````````````````````````````````````````````````````````=``````````````````````````````````
```````````````````````````=````````````````````````=============````````````````````=``````````````````````````````````
`````````````===============````````````````````````=```````````=````````````````````=``````````````````````````````````
`````````````=``````````=```````````````````````````[```````````=`````````============``````````````````````````````````
`````````````=$`````````[```````````````````````````=``````$````[`````````=``````````=``````````````````````````````````
`````````````============`````````````=====================================``````````=``````````````````````````````````
`````````````=````=`````===============`````[```````[`````````````````````[``````````=``````````````````````````````````
`````````````=````=`````[`````=```````=````================================``````````=``````````````````````````````````
`````````````=````=`````=`````[```````=````=````````=``````$````[`````````=``````````=``````````````````````````````````
````````````======================[====````=````````[```````````=`````````======[=====``````````````````````````````````
````````````=!`````[``=``=````=```````==[[==````````=```````````=````````````````````===========````````````````````````
````````````========``[``[````=========````=````````=============``````````````````````````````=````````````````````````
````````````========``[``[````[````````````=```````````````````````````````````````````````````=````````````````````````
````````````=$`````[``=``=````==============```````````````````````````````````````````````````=````````````````````````
````````````===[[=============``````=``````````````````````````````````````````````````````````=````````````````````````
`````````````````````=```````=``````[``````=====````````````````````````````````````````========````````````````````````
`````````````````````=```````[``````========~~~=```````````````````````````````````````````````=````````````````````````
`````````````````````=``$`D```==[======````=~~~````````````````````````````````````````````````=````````````````````````
`````````````````````=```````[````````=````=~~~=```````````````````````````````````````````````=````````````````````````
`````````````````````=========````````=````=====```````````````````````````````````````````````=````````````````````````
`````````````````````````````=````````=````````````````````````````````````````````````````````=````````````````````````
`````````````````````````````=```````[`````````````````````````````````````````````````````````=````````````````````````
`````````````````````````````=``````=``````````````````````````````````````````````````````````=````````````````````````
`````````````````````````````=======```````````````````````````````````````````````````````````=````````````````````````
```````````````````````=========``````````````````````````````````````````````````````````````=`````````````````````````
```````````````````````=`!~~```=`````````````````````````````````````````````````````````````=``````````````````````````
```````````````````````=`!~~```[````````````````````````````````````````````````````````````=```````````````````````````
``````````````````````=``!~~```=````````````````````````````````````````````````````========````````````````````````````
`````````````````````=$``!~~```=````````````````````````````````````````````````````=```````````````````````````````````
````````````````````============````````````````````````````````````````````````````=```````````````````````````````````
````````````````````````````````=======[========`````=====[=========````````````````=```````````````````````````````````
`````````````````````````````````=~~~~~~~~~~~=====[=======````````=`````````````````=```````````````````````````````````
``````````````````````````````````=``````````=````````=````$$````=`````````````````=````````````````````````````````````
```````````````````````````````````===============[================================`````````````````````````````````````
```````````````````````````````````````````````=$```$=``````````````````````````````````````````````````````````````````
```````````````````````````````````````````````=======``````````````````````````````````````````````````````````````````
````````````````````````````````````````````````````````````````````````````````````````````````````````````````````````
````````````````````````````````````````````````````````````````````````````````````````````````````````````````````````
````````````````````````````````````````````````````````````````````````````````````````````````````````````````````````
````````````````````````````````````````````````````````````````````````````````````````````````````````````````````````
````````````````````````````````````````````````````````````````````````````````````````````````````````````````````````
````````````````````````````````````````````````````````````````````````````````````````````````````````````````````````