````````````````````````````````````````````````````````````````````````````````````````````````````````````````````````
````````````````````````````````````````````````````````````````````````````````````````````````````````````````````````
````````````````````````````````````````````````````````````````````````````````````````````````````````````````````````
````````````````````````````````````````````````````````````````````````````````````````````````````````````````````````
``````==========================================================================================================````````
``````============`````````````````````````````````````````````````````````````````````````````````````````````=````````
``````=``````````=`````````````````````````````````````````````````````````````````````````````````````````````=````````
``````=``````````=`````````````````````````````````````````````````````````````````````````````````````````````=````````
``````=``````````=`````````````````````````````````````````````````````````````````````````````````````````````=````````
``````=``````````=`````````````````````````````````````````````````````````````````````````````````````````````=````````
``````=====[======`````````````````````````````````````````````````````````````````````````````````````````````=````````
``````=``````````=`````````````````````````````````````````````````````````````````````````````````````````````=````````
``````=``````````=`````````````````````````````````````````````````````````````````````````````````````````````=````````
``````=``````````=`````````````````````````````````````````````````````````````````````````````````````````````=````````
``````=``````````=`````````````````````````````````````````````````````````````````````````````````````````````=````````
``````=====[======`````````````````````````````````````````````````````````````````````````````````````````````=````````
``````=````````````````````````````````````````````````````````````````````````````````````````````````````````=````````
``````=````````````````````````````````````````````````````````````````````````````````````````````````````````=````````
``````=````````````````````````````````````````````````````````````````````````````````````````````````````````=````````
``````=````````````````````````````````````````````````````````````````````````````````````````````````````````=````````
``````=````````````````````````````````````````````````````````````````````````````````````````````````````````=````````
``````=````````````````````````````````````````````````````````````````````````````````````````````````````````=````````
``````=````````````````````````````````````````````````````````````````````````````````````````````````````````=````````
``````=````````````````````````````````````````````````````````````````````````````````````````````````````````=````````
``````=````````````````````````````````````````````````````````````````````````````````````````````````````````=````````
``````=````````````````````````````````````````````````````````````````````````````````````````````````````````=````````
``````=````````````````````````````````````````````````````````````````````````````````````````````````````````=````````
``````=````````````````````````````````````````````````````````````````````````````````````````````````````````=````````
``````=````````````````````````````````````````````````````````````````````````````````````````````````````````=````````
``````=````````````````````````````````````````````````````````````````````````````````````````````````````````=````````
``````=````````````````````````````````````````````````````````````````````````````````````````````````````````=````````
``````=````````````````````````````````````````````````````````````````````````````````````````````````````````=````````
``````=````````````````````````````````````````````````````````````````````````````````````````````````````````=````````
``````=````````````````````````````````````````````````````````````````````````````````````````````````````````=````````
``````=````````````````````````````````````````````````````````````````````````````````````````````````````````=````````
``````=````````````````````````````````````````````````````````````````````````````````````````````````````````=````````
``````=````````````````````````````````````````````````````````````````````````````````````````````````````````=````````
``````=````````````````````````````````````````````````````````````````````````````````````````````````````````=````````
``````=````````````````````````````````````````````````````````````````````````````````````````````````````````=````````
``````=````````````````````````````````````````````````````````````````````````````````````````````````````````=````````
``````=````````````````````````````````````````````````````````````````````````````````````````````````````````=````````
``````=````````````````````````````````````````````````````````````````````````````````````````````````````````=````````
``````=````````````````````````````````````````````````````````````````````````````````````````````````````````=````````
``````=````````````````````````````````````````````````````````````````````````````````````````````````````````=````````
``````=````````````````````````````````````````````````````````````````````````````````````````````````````````=````````
``````=````````````````````````````````````````````````````````````````````````````````````````````````````````=````````
``````=````````````````````````````````````````````````````````````````````````````````````````````````````````=````````
``````=````````````````````````````````````````````````````````````````````````````````````````````````````````=````````
``````=````````````````````````````````````````````````````````````````````````````````````````````````````````=````````
``````=````````````````````````````````````````````````````````````````````````````````````````````````````````=````````
``````=================================================[[[======================================================````````
``````=````````````````````````````````````````````````````````````````[```````````````````````````````````````=````````
``````=````````````````````````````````````````````````````````````````=========================================````````
``````=````````````````````````````````````````````````````````````````=========================================````````
``````=````````````````````````````````````````````````````````````````[```````````````````````````````````````=````````
``````==========================================================================================================````````
````````````````````````````````````````````````````````````````````````````````````````````````````````````````````````
````````````````````````````````````````````````````````````````````````````````````````````````````````````````````````
````````````````````````````````````````````````````````````````````````````````````````````````````````````````````````
````````````````````````````````````````````````````````````````````````````````````````````````````````````````````````
