````````````````````````````````````````````````````````````````````````````````````````````````````````````````````````
````````````````````````````````````````````````````````````````````````````````````````````````````````````````````````
````````````````````````````````````````````````````````````````````````````````````````````````````````````````````````
````````````````````````````````````````````````````````````````````````````````````````````````````````````````````````
``````==========================================================================================================````````
``````============````=`````=```````````=``````````=``````=```````````````````=````````````````````````````````=````````
``````=``=```````[````==[====```````````=```````````=`````=```````````````````=````````````````````````````````=````````
``````=```=[==```=``````````[```````````=````````````=````=```````````````````=````````````````````````````````=````````
``````=``````=====`````======```````````=======```````=====```````````````````=````````````````````````````````=````````
``````=``````````=`````[````=```````````=`````=```````=```````````````````````=````````````````````````````````=````````
``````=====[=========[=============[=====`````=```````=```````````````````````=````````````````````````````````=````````
``````=``````````=``````..``=```````````=======```````=```````````````````````=````````````````````````````````=````````
``````=``````````=``````````[```````````=`````````````=```````````````````````=````````````````````````````````=````````
``````=`AAAA`````=``````````=````!!!````=`````````````=```````````````````````=````````````````````````````````=````````
``````=``````````=``````````=```````````=`````````````=```````````````````````=````````````````````````````````=````````
``````=====[=============================`````````````=```````````````````````=````````````````````````````````=````````
``````=````````=````=````=````````[``$``=======================================````````````````````````````````=````````
``````=````````[````=````=````````=`````=````=````````=`````=````=````````````=````````````````````````````````=````````
``````=````````[````==[[==````````=======````=````````=`````=````=`,,,,,,,,,,`=````````````````````````````````=````````
``````=````````=``````````````````[````$==[===````````[`````==[===`,~~~~~~~~,`=````````````````````````````````=````````
``````=================[[================`````````````=``````````=`,~~~~~~~~,`=````````````````````````````````=````````
``````=``````=````````````````=`````````=======[==================`,~~~#~~~~,`=````````````````````````````````=````````
``````=``````[````````````````[`````````=````````=`%%`[````=`````=`,~~~#~~~~,`=````````````````````````````````=````````
``````==========[==============`````````=````````[````=````=`````=`,,,,,,,,,,`=````````````````````````````````=````````
``````=``````[````````````````[`````````=````%```=======[===`````=````````````=````````````````````````````````=````````
``````=``````=````````````````=`````````[`````````````=``````````=````````````=````````````````````````````````=````````
``````==================================================================[======````````````````````````````````=````````
``````=`,!!!,,``=`````=`````===================````````````````````````````````````````````````````````````````=````````
``````=`````````=`````[`````=D,[``%`````=````$====================`````````````````````````````````````````````=````````
``````=====[=====`````=======,,=````````[``````````=`````````````=`````````````````````````````````````````````=````````
``````=`````````===[===`````==========[==``````````[`````````````=`````````````````````````````````````````````=````````
``````=`````````=`````[`````=```=`$$=```============`````````````=`````````````````````````````````````````````=````````
``````======````===========`[```=[===```=``````````=======[[======`````````````````````````````````````````````=````````
``````=````[`````=```$````=`[```````````[``````````=```````````````````````````````````````````````````````````=````````
``````=````=`````[````````=`=```````````=``````````=```````````````````````````````````````````````````````````=````````
``````==================[===========================```````````````````````````````````````````````````````````=````````
``````=````=```=``````=```````[`````=``````````````````````````````````````````````````````````````````````````=````````
``````=````[````[`````=````````=```[`=======```````````````````````````````````````````````````````````````````=````````
``````=````=````==````====[[=====`=````````=```````````````````````````````````````````````````````````````````=````````
``````========[==`=```=``````````===========```````````````````````````````````````````````````````````````````=````````
``````=````````````=``=`````````=``````````````````````````````````````````````````````````````````````````````=````````
``````===[==============[=======```````````````````````````````````````````````````````````````````````````````=````````
``````=`````=````~````$=`=``````````````````===========````````````````````````````````````````````````````````=````````
``````=`````=!!!!=======`=``````````````````=$```````%=````````````````````````````````````````````````````````=````````
``````=`````=````=$````[`=``````````````````=====`=====````````````````````````````````````````````````````````=````````
``````=`````[`````=%```=`=``````````````````````=`=````````````````````````````````````````````````````````````=````````
``````=`````=``````=%``=[=``````````````````````=`=````````````````````````````````````````````````````````````=````````
``````=`````===[========`========================[=========````````````````````````````````````````````````````=````````
``````=`````=``````````=`[````````````````````````````````=````````````````````````````````````````````````````=````````
``````=`````=``````````=`==============================```=````````````````````````````````````````````````````=````````
``````==================[==============================[[[======================================================````````
``````=$```````=``````=```=```````````````````````````````=```````=````[```````````````````````````````````````=````````
``````=````````=``````==[==```````````````````````````````[```````==[===========================================````````
``````=====[====``````````````````````````````````````````[````````````=========================================````````
``````=```````````````````````````````````````````````````=````````````[```````````````````````````````````````=````````
``````==========================================================================================================````````
````````````````````````````````````````````````````````````````````````````````````````````````````````````````````````
````````````````````````````````````````````````````````````````````````````````````````````````````````````````````````
````````````````````````````````````````````````````````````````````````````````````````````````````````````````````````
````````````````````````````````````````````````````````````````````````````````````````````````````````````````````````
