========================================================================================================================
==````[````=````=````=````=````=````=````=````=````=````[[````=````=````=`````=````[````=````=````=````=````=````[````==
=`=````=````=````=````=````[````=````=````=````[````=```==```=````=````=`````=````=````=````=````=````=````=````=````=`=
=``=````=````=````=````=````=````=````=````=````=````[``==``[````=````=`````=````=````=````=````=````=````=````=````=``=
=```=````=````=````=````=````=````=````[````=````=````=$==$=````=````[`````=````=````=````=````=````[````=````=````=```=
=````=````=````=````[````=````=````=````=````=````=````====````=````=`````=````=````=````=````=````=````=````=````=````=
==````=````=````=````=````=````=````=````=````=````=````==````=````=`````=````=````=````=````=````=````=````=````=````==
=`=````=````=````=````=````=````=````=````=````=````=```==```=````=`````=````=````=````[````=````=````=````=````=````=`=
=``=````=````=````=````=````=````=````=````=````=````=``[[``=````=`````[````=````=````=````=````=````=````=````=````=``=
=```=````=````=````=````=````=````=````=````=````=````=`==`[````=`````=````=````=````=````=````=````=````=````=````=```=
=````=````=````=````=````=````=````=````[````=````=````====````=`````=````=````=````=````=````=````=````=````=````=````=
=`````=````[````=````=````=````=````=````=````=````=````==````=`````=````=````=````=````[````=````=````=````[````=`````=
=``````=````=````=````=````=````=````=````=````=````=```==```=`````=````=````=````=````=````=````=````=````=````=``````=
========[=====`~~~=````[````=````=````=````=````=````[``==``=`````=````=````=````=````=````=````[````=````=====[========
=~~~~~~=``````=$$$$=````=````=````[````=````=````=````=`==`=`````=````=````[````=````=````=````=````=`%$`=``````=~~~~~~=
========```````======````=````=````=````=````=````=````====`````=````=````=````=````=````=````=````======```````========
==============[=========================================================================================================
=`````````````````````````````````=```````````````[```$====%```[````````````````````````=``==``==``[```=```[```=```[```=
=`````````````````````````````````=````````````````=``=`==`=``=`````````````````````````=``[[``==``=```=```=```=```=```=
=`````````````````````````````````=`````````````````==``==``==``````````````````````````=``==``==``=```[```=```[```=```=
=```````````#########`````````````=`````````````````=```==```=``````````````````````````=``===[===========[===[=========
=```````````#~~~~~~~#``````````````````````````````=````==````=`````````````````````````=``[[``==``=```[```=```=```[```=
=```````````#~~~~~~~#`````````````=```````````````=`````[[`````=````````````````````````=``==``[[``[```=```[```[```=```=
=```````````#~~~~~~~#@@@@@````````=``````````````=``````[[``````=```````````````````````=``==========[===[=======[==[===
=```````````#######`#`````````````=`````````````=```````==```````=``````````````````````[``[[``==``=```[```[```[```=```=
=`````````````````````````````````=````````````=````````==````````=`````````````````````=``==``==``[```=```=```=```[```=
=`````````````````````````````````=```````````[`````````==`````````[````````````````````=``======[=======[===[===[====[=
=`````````````````````````````````=``````````=``````````==``````````=```````````````````=``==``==``=```=```[```=```=```=
=`````````````````````````````````=`````````=```````````==```````````=``````````````````=``==``==``[```=```=```=```=```=
======================================================[====[==========================================[==[===[==========
=```````````````````````````````````````````[`````[`````==`````[`````[``````````````````=``==``[```=```[```=```=```=```=
=````````````````````````````````````````````=```=``````````````=```=```````````````````=``==``=```[```=```=```=```=```=
=`````````````````````````````````````````````=[[=``````[[``````=[[=````````````````````=====[==[=====[==[======[=======
=``````````````````````````````````````````````=``=`````==`````=``=`````````````````````=``==``=```=```[```=```[```=```=
=`````````````````````````````````````@`````````=``=````==````=``=``````````````````````=``==``=```[```=```[```=```=```=
=````````````````````````````````````````````````=``=```==```=``=```````````````````````======[=======[=[====[==[===[===
=`````````````````````````````@```````````````````=``=``==``=``=````````````````````````=``==``=```=```=```[```=```=```=
=``````````````````````````````````````````````````=$$======%%=`````````````````````````=``[[``[```[```[```=```[```[`D`=
========================================================================================================================
========```````======````=````=````=````=```````````````==`````````````````````````````````````````======```````========
=~~~~~~=``````=`%$`=````=````=````=````=````````````````==``````````````````````````````````````````=$$$$=``````=~~~~~~=
========[=====`~~~=````=````=````=````=`````````````````==```````````````````````````````````````````=~~~`=====[========
=``````=````=````=````=````=````=````=``````````````````==````````````````````````````````````````````=````=````=``````=
=`````=````=````=````=````=````=````=```````````````````==`````````````````````````````````````````````=````=````=`````=
=````=````=````=````=````=````=````=````````````````````==``````````````````````````````````````````````=````=````=````=
=```=````=````=````=````=````=````=`````````````````````[[```````````````````````````````````````````````=````=````=```=
=``=````=````=````=````=````=````=``````````````````````==````````````````````````````````````````````````=````=````=``=
=`=````=````=````=````=````=````=```````````````````````==`````````````````````````````````````````````````=````=````=`=
==````=````=````=````=````=````=````````````````````````==``````````````````````````````````````````````````=````=````==
=````=````=````=````=````=````=`````````````````````````==```````````````````````````````````````````````````=````=````=
=```=````=````=````=````=````=``````````````````````````==````````````````````````````````````````````````````=````=```=
=``=````=````=````=````=````=```````````````````````````==`````````````````````````````````````````````````````=````=``=
=`=````=````=````=````=````=````````````````````````````[[``````````````````````````````````````````````````````=````=`=
========================================================[[==============================================================
```````````````````````````````````````````````````````=``=````````````````````````````````````````````````````````````=
```````````````````````````````````````````````````````=``=````````````````````````````````````````````````````````````=
`=======================================================[[==============================================================
`=`=`=`=`=`=`=`=`=`=`=`=`=`=`=`=`=`=`=`=`=`=`=`=`=`=`=`=``=`=`=`=`=`=`=`=`=`=`=`=`=````````````````````````````````````=
`=`=`=`=`=`=`=`=`=`=`=`=`=`=`=`=`=`=`=`=`=`=`=`=`=`=`=`=``=`=`=`=`=`=`=`=`=`=`=`=`=````````````````````````````````````=
`=======================================================================================================================
