================================================================````````````````````````````````````````````````````````
=``D`````````````````````````````````````````````````['''$$$'''=`````````````````================```````````````````````
=````````````````````````````````````````````````````='''''''''=`````````````````=```````$``````=```````````````````````
=````````````````````````````````````````````````````='''''''''=`````````````````=``````````````=```````````````````````
=````````````````````````````````````````````````````='''''''''=`````````````````=``````````````=```````````````````````
=``````~~~```````````````````````````````````````````='''''''''=`````````````````=``````````````=```````````````````````
=```````~~```````````````````````````````````````````=====[[====`````````````============[=========`````````````````````
=````````````````````````````````````````````````````=`````````=`````````````=````````````````````=`````````````````````
=````````````````````````````````````````````````````=`````````===============````````````````````=`````````````````````
=````````````````````````````=========================````````$=`````````````=````````````````````=`````````````````````
=````````````````````````````=```````````=```````````=`````````=`````````````=````````````````````=`````````````````````
=````````````````````````````=````````````[```````````[````````=`````````````=========[============`````````````````````
=`````````````````````````============================`````````=[=============````````````$`````==================``````
=`````````````````````````=``````````$```````=```````=`````````=`````````````[``````````````````=````````````````=``````
=`````````````````````````=``````````````````=```````=====[=====`````````````=``````````````````=````````````````=``````
=`````````````````````````=``````````````````[```````[`````````=========================================`````````=``````
=`````````````````````````=``````````````````=```````=````~~```=``````=`````````=```````=``````````````=`````````=``````
======================================================`````````=``````=`````````=```````[``````````````=`````````=``````
```````````````````=```````````````````````````````````````````=``````=`````````=```````=``````````````=`````````=``````
```````````````````=```````````````````````````````````````````=``````=`````````[```````=``````````````=`````````=``````
`````````=====================`````==========[===========[=============`````````=```````======[[==================``````
`````````=``````=````````````=`````=``````````````$`````=`````````````=`````````=```````[``````````````=`````````=``````
`````````=$`````[````````````=`````=````````````````````=````~~~~~````===========```````=``````````````=`````````=``````
``````========================`````=````````````````````=`````````````=`````````====[========[===``````[`````````=``````
``````=`````````=```=``````````````=````````````````````=======[[======`````````=```````=```````==================``````
``````=====[=====```=````````==================`````````[`````````````=`````````=```````=``````````=```````=````````````
``````=`````````[```=``````````````=``````````=`````````=`````````````[`````````=```````[``````````=```````=````````````
``````=`````````=```=``````````````[``````````=`````````=`````````````=`````````[```````=``````````[```````=````````````
``````=`````````=```=====[==========``````````=`````````=`````````````=`````````=```````=``````````=```````=````````````
``````======[====```=``````````````=``````````=`````````========[========[==================================````````````
``````=`````````=```=`````````````U=``````````=`````````=,,,,,,,,,,,,,,=```````=`````````=``````````````=```````````````
==================[[=``````````````=``````````=`````````=~~~~~,,,,~~~~~=```````=`````````=``````````````=```````````````
=~~~~~~~~~~,,,,=````=========[=====================[[====~~~~~,,,,~~~~~[```````[`````````=``````````````=```````````````
=,,~~~~~~,,,,,,[`````=`````=````$``````=````````````````=,,,,,,,,,,,,,,=```$```=`````````========[[======```````````````
=,$,~,,,,,,,,,,=`````=`````[```````````=````````````````=======[==========================``````````````=```````````````
=,,~~~~~,,,,,,,=`````=`````=```````````=````````````````=``````````````````[`````````````=``````````````=```````````````
================`````[`````=```````````[````````````````=``````````````````[`````````````[``````````````=```````````````
```````````````===[===`````=```````````=````````````````=`==========[=====================================``````````````
```````````````=`````=`````=============`````````````````````````````=``````````````````````````````````````````````````
```````````````=``$``=`````````````````=`````````````````````````````=``````````````````````````````````````````````````
```````````````=======================================================``````````````````````````````````````````````````
