````````````````````````````````````````````````````````````````````````````````````````````````````````````````````````
````````````````````````````````````````````````````````````````````````````````````````````````````````````````````````
````````````````````````````````````````````````````````````````````````````````````````````````````````````````````````
````````````````````````````````````````````````````````````````````````````````````````````````````````````````````````
``````==========================================================================================================````````
``````============``````````=```````````=``````````````````````````````````````````````````````````````````````=````````
``````=``````````=``````````=```````````=``````````````````````````````````````````````````````````````````````=````````
``````=``````````=``````````[```````````=``````````````````````````````````````````````````````````````````````=````````
``````=``````````=``````````=```````````=``````````````````````````````````````````````````````````````````````=````````
``````=``````````=``````````=```````````=``````````````````````````````````````````````````````````````````````=````````
``````=====[=========[=============[=====``````````````````````````````````````````````````````````````````````=````````
``````=``````````=``````````=```````````=``````````````````````````````````````````````````````````````````````=````````
``````=``````````=``````````[```````````=``````````````````````````````````````````````````````````````````````=````````
``````=``````````=``````````=```````````=``````````````````````````````````````````````````````````````````````=````````
``````=``````````=``````````=```````````=``````````````````````````````````````````````````````````````````````=````````
``````=====[=============================``````````````````````````````````````````````````````````````````````=````````
``````=`````````````````````````````````=``````````````````````````````````````````````````````````````````````=````````
``````=`````````````````````````````````=``````````````````````````````````````````````````````````````````````=````````
``````=`````````````````````````````````=``````````````````````````````````````````````````````````````````````=````````
``````=`````````````````````````````````=``````````````````````````````````````````````````````````````````````=````````
``````=================[[================``````````````````````````````````````````````````````````````````````=````````
``````=``````=````````````````=`````````=``````````````````````````````````````````````````````````````````````=````````
``````=``````[````````````````[`````````=``````````````````````````````````````````````````````````````````````=````````
``````==========[==============`````````=``````````````````````````````````````````````````````````````````````=````````
``````=``````[````````````````[`````````=``````````````````````````````````````````````````````````````````````=````````
``````=``````=````````````````=`````````[``````````````````````````````````````````````````````````````````````=````````
``````===================================``````````````````````````````````````````````````````````````````````=````````
``````=`,!!!,,``=```````````===================````````````````````````````````````````````````````````````````=````````
``````=`````````=```````````=D,[````````=````$======```````````````````````````````````````````````````````````=````````
``````=====[=====```````````=,,=````````[``````````=```````````````````````````````````````````````````````````=````````
``````=`````````````````````=============``````````[```````````````````````````````````````````````````````````=````````
``````=`````````````````````=```=`$$=```============```````````````````````````````````````````````````````````=````````
``````=`````````````````````[```=[===```=``````````=```````````````````````````````````````````````````````````=````````
``````=`````````````````````[```````````[``````````=```````````````````````````````````````````````````````````=````````
``````=`````````````````````=```````````=``````````=```````````````````````````````````````````````````````````=````````
``````==============================================```````````````````````````````````````````````````````````=````````
``````=````````````````````````````````````````````````````````````````````````````````````````````````````````=````````
``````=````````````````````````````````````````````````````````````````````````````````````````````````````````=````````
``````=````````````````````````````````````````````````````````````````````````````````````````````````````````=````````
``````=````````````````````````````````````````````````````````````````````````````````````````````````````````=````````
``````=````````````````````````````````````````````````````````````````````````````````````````````````````````=````````
``````=````````````````````````````````````````````````````````````````````````````````````````````````````````=````````
``````=````````````````````````````````````````````````````````````````````````````````````````````````````````=````````
``````=````````````````````````````````````````````````````````````````````````````````````````````````````````=````````
``````=````````````````````````````````````````````````````````````````````````````````````````````````````````=````````
``````=````````````````````````````````````````````````````````````````````````````````````````````````````````=````````
``````=````````````````````````````````````````````````````````````````````````````````````````````````````````=````````
``````=````````````````````````````````````````````````````````````````````````````````````````````````````````=````````
``````=````````````````````````````````````````````````````````````````````````````````````````````````````````=````````
``````=````````````````````````````````````````````````````````````````````````````````````````````````````````=````````
``````=================================================[[[======================================================````````
``````=````````````````````````````````````````````````````````````````[```````````````````````````````````````=````````
``````=````````````````````````````````````````````````````````````````=========================================````````
``````=````````````````````````````````````````````````````````````````=========================================````````
``````=````````````````````````````````````````````````````````````````[```````````````````````````````````````=````````
``````==========================================================================================================````````
````````````````````````````````````````````````````````````````````````````````````````````````````````````````````````
````````````````````````````````````````````````````````````````````````````````````````````````````````````````````````
````````````````````````````````````````````````````````````````````````````````````````````````````````````````````````
````````````````````````````````````````````````````````````````````````````````````````````````````````````````````````
