========================================================================================================================
==````````````````````````````````````````````````````````````````````````````````````````````````````````````````````==
=`=``````````````````````````````````````````````````````````````````````````````````````````````````````````````````=`=
=``=````````````````````````````````````````````````````````````````````````````````````````````````````````````````=``=
=```=``````````````````````````````````````````````````````````````````````````````````````````````````````````````=```=
=````=````````````````````````````````````````````````````````````````````````````````````````````````````````````=````=
=`````=``````````````````````````````````````````````````````````````````````````````````````````````````````````=`````=
=``````=````````````````````````````````````````````````````````````````````````````````````````````````````````=``````=
=```````=``````````````````````````````````````````````````````````````````````````````````````````````````````=```````=
=````````=````````````````````````````````````````````````````````````````````````````````````````````````````=````````=
=`````````=``````````````````````````````````````````````````````````````````````````````````````````````````=`````````=
=``````````=````````````````````````````````````````````````````````````````````````````````````````````````=``````````=
=```````````=``````````````````````````````````````````````````````````````````````````````````````````````=```````````=
=````````````=````````````````````````````````````````````````````````````````````````````````````````````=````````````=
=`````````````=``````````````````````````````````````````````````````````````````````````````````````````=`````````````=
=``````````````=````````````````````````````````````````````````````````````````````````````````````````=``````````````=
========================================================================================================================
=``````````````````````````````````````````````````````````````````````````````````````````````````````````````````````=
=``````````````````````````````````````````````````````````````````````````````````````````````````````````````````````=
=``````````````````````````````````````````````````````````````````````````````````````````````````````````````````````=
=``````````````````````````````````````````````````````````````````````````````````````````````````````````````````````=
=``````````````````````````````````````````````````````````````````````````````````````````````````````````````````````=
=``````````````````````````````````````````````````````````````````````````````````````````````````````````````````````=
=``````````````````````````````````````````````````````````````````````````````````````````````````````````````````````=
=``````````````````````````````````````````````````````````````````````````````````````````````````````````````````````=
```````````````````````````````````````````````````````````````````````````````````````````````````````````````````````=
=``````````````````````````````````````````````````````````````````````````````````````````````````````````````````````=
=``````````````````````````````````````````````````````````````````````````````````````````````````````````````````````=
=``````````````````````````````````````````````````````````````````````````````````````````````````````````````````````=
=``````````````````````````````````````````````````````````````````````````````````````````````````````````````````````=
=``````````````````````````````````````````````````````````````````````````````````````````````````````````````````````=
=``````````````````````````````````````````````````````````````````````````````````````````````````````````````````````=
=``````````````````````````````````````````````````````````````````````````````````````````````````````````````````````=
=``````````````````````````````````````````````````````````````````````````````````````````````````````````````````````=
=``````````````````````````````````````````````````````````````````````````````````````````````````````````````````````=
=``````````````````````````````````````````````````````````````````````````````````````````````````````````````````````=
=``````````````````````````````````````````````````````````````````````````````````````````````````````````````````````=
=``````````````````````````````````````````````````````````````````````````````````````````````````````````````````````=
=``````````````````````````````````````````````````````````````````````````````````````````````````````````````````````=
=``````````````````````````````````````````````````````````````````````````````````````````````````````````````````````=
=``````````````````````````````````````````````````````````````````````````````````````````````````````````````````````=
=``````````````````````````````````````````````````````````````````````````````````````````````````````````````````````=
=``````````````````````````````````````````````````````````````````````````````````````````````````````````````````````=
=``````````````````````````````````````````````````````````````````````````````````````````````````````````````````````=
=``````````````````````````````````````````````````````````````````````````````````````````````````````````````````````=
=``````````````````````````````````````````````````````````````````````````````````````````````````````````````````````=
=``````````````````````````````````````````````````````````````````````````````````````````````````````````````````````=
=``````````````````````````````````````````````````````````````````````````````````````````````````````````````````````=
=``````````````````````````````````````````````````````````````````````````````````````````````````````````````````````=
=``````````````````````````````````````````````````````````````````````````````````````````````````````````````````````=
=``````````````````````````````````````````````````````````````````````````````````````````````````````````````````````=
=``````````````````````````````````````````````````````````````````````````````````````````````````````````````````````=
=``````````````````````````````````````````````````````````````````````````````````````````````````````````````````````=
=``````````````````````````````````````````````````````````````````````````````````````````````````````````````````````=
=``````````````````````````````````````````````````````````````````````````````````````````````````````````````````````=
=``````````````````````````````````````````````````````````````````````````````````````````````````````````````````````=
=``````````````````````````````````````````````````````````````````````````````````````````````````````````````````````=
========================================================================================================================
````````````````````````````````````````````````````````````````````````````````````````````````````````````````````````
````````````````````````````````````````````````````````````````````````````````````````````````````````````````````````
