````````````````````````````````````````````````````````````````````````````````````````````````````````````````````````
````````````````````````````````````````==================``````````````````````````````````````````````````````````````
````````````````````````````````````````=```=``$``=``````=``````==========``````````````````````````````````````````````
````````````````````````````````````````=```=`````=``````=``````=````````=``````````````````````````````````````````````
````````````````````````````````````````=```=`````=``````=``````=````U```=``````````````````````````````````````````````
````````````````````````````````````````=```===[===``````=``````=$```````=========``````````````````````````````````````
````````````````````````````````````````=````````````````=``````=````````=````````=`````````````````````````````````````
`````````````````````````````````========````````````````========````````[`````````=````````````````````````````````````
`````````````````````````````````=``````````````````````````````==========``````````=```````````````````````````````````
`````````````````````````````````=```````````````````````````````````````=====[[======``````````````````````````````````
`````````````````````````````````=```````````````````````````````````````````````````=``````````````````````````````````
`````````````````````````````````=```````````````````````````````````````````````````=``````````````````````````````````
```````````````````````````=======```````````````````````````````````````````````````=``````````````````````````````````
```````````````````````````=`````````````````````````````````````````````````````````=``````````````````````````````````
```````````````````````````=````````````````````````=============````````````````````=``````````````````````````````````
`````````````===============````````````````````````=````````````````````````````````=``````````````````````````````````
`````````````=``````````=```````````````````````````=`````````````````````============``````````````````````````````````
`````````````=$`````````[```````````````````````````=```````````[`````````=``````````=``````````````````````````````````
`````````````============```````````````````````````=======================``````````=``````````````````````````````````
`````````````=````=`````=`````````````````````````````````````````````````[``````````=``````````````````````````````````
`````````````=````=`````[```````````````````````````=======================``````````=``````````````````````````````````
`````````````=````=`````=```````````````````````````=`````````````````````=``````````=``````````````````````````````````
`````````````==================`````````````````````=`````````````````````======[=====``````````````````````````````````
``````````````````````````````=`````````````````````=============````````````````````===========````````````````````````
``````````````````````````````=`````````````````````````````````````````````````````````````````````````````````````````
``````````````````````````````=`````````````````````````````````````````````````````````````````````````````````````````
``````````````````````````````=`````````````````````````````````````````````````````````````````````````````````````````
`````````````````````==========`````````````````````````````````````````````````````````````````````````````````````````
`````````````````````=``````````````````````````````````````````````````````````````````````````````````````````````````
`````````````````````=``````````````````````````````````````````````````````````````````````````````````````````````````
`````````````````````=``$`D`````````````````````````````````````````````````````````````````````````````````````````````
`````````````````````=``````````````````````````````````````````````````````````````````````````````````````````````````
`````````````````````=========``````````````````````````````````````````````````````````````````````````````````````````
`````````````````````````````=``````````````````````````````````````````````````````````````````````````````````````````
`````````````````````````````=``````````````````````````````````````````````````````````````````````````````````````````
`````````````````````````````=``````````````````````````````````````````````````````````````````````````````````````````
`````````````````````````````=``````````````````````````````````````````````````````````````````````````````````````````
```````````````````````=========````````````````````````````````````````````````````````````````````````````````````````
```````````````````````=`!~~```=````````````````````````````````````````````````````````````````````````````````````````
```````````````````````=`!~~```[````````````````````````````````````````````````````````````````````````````````````````
``````````````````````=``!~~```=````````````````````````````````````````````````````````````````````````````````````````
`````````````````````=$``!~~```=````````````````````````````````````````````````````````````````````````````````````````
````````````````````============````````````````````````````````````````````````````````````````````````````````````````
````````````````````````````````````````````````````````````````````````````````````````````````````````````````````````
````````````````````````````````````````````````````````````````````````````````````````````````````````````````````````
````````````````````````````````````````````````````````````````````````````````````````````````````````````````````````
````````````````````````````````````````````````````````````````````````````````````````````````````````````````````````
````````````````````````````````````````````````````````````````````````````````````````````````````````````````````````
````````````````````````````````````````````````````````````````````````````````````````````````````````````````````````
````````````````````````````````````````````````````````````````````````````````````````````````````````````````````````
````````````````````````````````````````````````````````````````````````````````````````````````````````````````````````
````````````````````````````````````````````````````````````````````````````````````````````````````````````````````````
````````````````````````````````````````````````````````````````````````````````````````````````````````````````````````
````````````````````````````````````````````````````````````````````````````````````````````````````````````````````````
````````````````````````````````````````````````````````````````````````````````````````````````````````````````````````