========================================================================================================================
==``````````````````````````````````````````````````````==````````````````````````````````````````````````````````````==
=`=`````````````````````````````````````````````````````==```````````````````````````````````````````````````````````=`=
=``=````````````````````````````````````````````````````==``````````````````````````````````````````````````````````=``=
=```=```````````````````````````````````````````````````==`````````````````````````````````````````````````````````=```=
=````=``````````````````````````````````````````````````==````````````````````````````````````````````````````````=````=
=`````=`````````````````````````````````````````````````==```````````````````````````````````````````````````````=`````=
=``````=````````````````````````````````````````````````==``````````````````````````````````````````````````````=``````=
=```````=```````````````````````````````````````````````[[`````````````````````````````````````````````````````=```````=
=````````=``````````````````````````````````````````````==````````````````````````````````````````````````````=````````=
=`````````=`````````````````````````````````````````````==```````````````````````````````````````````````````=`````````=
=``````````=````````````````````````````````````````````==``````````````````````````````````````````````````=``````````=
=```````````=```````````````````````````````````````````==`````````````````````````````````````````````````=```````````=
=````````````=``````````````````````````````````````````==````````````````````````````````````````````````=````````````=
=`````````````=`````````````````````````````````````````==```````````````````````````````````````````````=`````````````=
=``````````````=````````````````````````````````````````==``````````````````````````````````````````````=``````````````=
========================================================================================================================
=```````````````````````````````````````````````````````==`````````````````````````````````````````````````````````````=
=```````````````````````````````````````````````````````==`````````````````````````````````````````````````````````````=
=```````````````````````````````````````````````````````==`````````````````````````````````````````````````````````````=
=```````````````````````````````````````````````````````==`````````````````````````````````````````````````````````````=
=```````````````````````````````````````````````````````==`````````````````````````````````````````````````````````````=
=```````````````````````````````````````````````````````==`````````````````````````````````````````````````````````````=
=```````````````````````````````````````````````````````==`````````````````````````````````````````````````````````````=
=```````````````````````````````````````````````````````==`````````````````````````````````````````````````````````````=
````````````````````````````````````````````````````````==`````````````````````````````````````````````````````````````=
=```````````````````````````````````````````````````````==`````````````````````````````````````````````````````````````=
=```````````````````````````````````````````````````````==`````````````````````````````````````````````````````````````=
=```````````````````````````````````````````````````````==`````````````````````````````````````````````````````````````=
=```````````````````````````````````````````````````````==`````````````````````````````````````````````````````````````=
=```````````````````````````````````````````````````````==`````````````````````````````````````````````````````````````=
=```````````````````````````````````````````````````````==`````````````````````````````````````````````````````````````=
=```````````````````````````````````````````````````````==`````````````````````````````````````````````````````````````=
=```````````````````````````````````````````````````````==`````````````````````````````````````````````````````````````=
=```````````````````````````````````````````````````````==`````````````````````````````````````````````````````````````=
=```````````````````````````````````````````````````````==`````````````````````````````````````````````````````````````=
=```````````````````````````````````````````````````````==`````````````````````````````````````````````````````````````=
=```````````````````````````````````````````````````````==`````````````````````````````````````````````````````````````=
=```````````````````````````````````````````````````````==`````````````````````````````````````````````````````````````=
=```````````````````````````````````````````````````````==`````````````````````````````````````````````````````````````=
=````````````````````````````````````````````````````````=`````````````````````````````````````````````````````````````=
=```````````````````````````````````````````````````````==`````````````````````````````````````````````````````````````=
========================================================================================================================
=`````````````=`````````````````````````````````````````==```````````````````````````````````````````````=`````````````=
=````````````=``````````````````````````````````````````==````````````````````````````````````````````````=````````````=
=```````````=```````````````````````````````````````````==`````````````````````````````````````````````````=```````````=
=``````````=````````````````````````````````````````````==``````````````````````````````````````````````````=``````````=
=`````````=`````````````````````````````````````````````==```````````````````````````````````````````````````=`````````=
=````````=``````````````````````````````````````````````==````````````````````````````````````````````````````=````````=
=```````=```````````````````````````````````````````````==`````````````````````````````````````````````````````=```````=
=``````=````````````````````````````````````````````````==``````````````````````````````````````````````````````=``````=
=`````=`````````````````````````````````````````````````==```````````````````````````````````````````````````````=`````=
=````=``````````````````````````````````````````````````==````````````````````````````````````````````````````````=````=
=```=```````````````````````````````````````````````````==`````````````````````````````````````````````````````````=```=
=``=````````````````````````````````````````````````````==``````````````````````````````````````````````````````````=``=
=`=`````````````````````````````````````````````````````==```````````````````````````````````````````````````````````=`=
==``````````````````````````````````````````````````````==````````````````````````````````````````````````````````````==
========================================================================================================================
````````````````````````````````````````````````````````````````````````````````````````````````````````````````````````
````````````````````````````````````````````````````````````````````````````````````````````````````````````````````````
