========================================================================================================================
==````[````=````=````=````=````=````=````=````=````=````[[````=````=````=`````=````=````=````=````=````=````=````[````==
=`=````=````=````=````=````[````=````=````=````[````=```==```=````=````=`````=````=````=````=````=````=````=````=````=`=
=``=````=````=````=````=````=````=````=````=````=````[``==``[````=````=`````=````=````=````=````=````=````=````=````=``=
=```=````=````=````=````=````=````=````[````=````=````=$==$=````=````=`````=````=````=````=````=````=````=````=````=```=
=````=````=````=````[````=````=````=````=````=````=````====````=````=`````=````=````=````=````=````=````=````=````=````=
==````=````=````=````=````=````=````=````=````=````=````==````=````=`````=````=````=````=````=````=````=````=````=````==
=`=````=````=````=````=````=````=````=````=````=````=```==```=````=`````=````=````=````=````=````=````=````=````=````=`=
=``=````=````=````=````=````=````=````=````=````=````=``[[``=````=`````=````=````=````=````=````=````=````=````=````=``=
=```=````=````=````=````=````=````=````=````=````=````=`==`=````=`````=````=````=````=````=````=````=````=````=````=```=
=````=````=````=````=````=````=````=````[````=````=````====````=`````=````=````=````=````=````=````=````=````=````=````=
=`````=````[````=````=````=````=````=````=````=````=````==````=`````=````=````=````=````=````=````=````=````[````=`````=
=``````=````=````=````=````=````=````=````=````=````=```==```=`````=````=````=````=````=````=````=````=````=````=``````=
========[=====`~~~=````[````=````=````=````=````=````[``==``=`````=````=````=````=````=````=````=````=````=====[========
=~~~~~~=``````=$$$$=````=````=````[````=````=````=````=`==`=`````=````=````=````=````=````=````=````=`%$`=``````=~~~~~~=
========```````======````=````=````=````=````=````=````====`````=````=````=````=````=````=````=````======```````========
==============[=========================================================================================================
=`````````````````````````````````````````````````[```$====%```[````````````````````````=``==``==``[```=```[```=```[```=
=``````````````````````````````````````````````````=``=`==`=``=`````````````````````````=``[[``==``=```=```=```=```=```=
=```````````````````````````````````````````````````==``==``==``````````````````````````=``==``==``=```[```=```[```=```=
=```````````````````````````````````````````````````=```==```=``````````````````````````=``===[===========[===[=========
=``````````````````````````````````````````````````=````==````=`````````````````````````=``[[``==``=```[```=```=```[```=
=`````````````````````````````````````````````````=`````[[`````=````````````````````````=``==``[[``[```=```[```[```=```=
=````````````````````````````````````````````````=``````[[``````=```````````````````````=``==========[===[=======[==[===
=```````````````````````````````````````````````=```````==```````=``````````````````````[``[[``==``=```[```[```[```=```=
=``````````````````````````````````````````````=````````==````````=`````````````````````=``==``==``[```=```=```=```[```=
=`````````````````````````````````````````````[`````````==`````````[````````````````````=``======[=======[===[===[====[=
=````````````````````````````````````````````=``````````==``````````=```````````````````=``==``==``=```=```[```=```=```=
=```````````````````````````````````````````=```````````==```````````=``````````````````=``==``==``[```=```=```=```=```=
======================================================[====[==========================================[==[===[==========
=```````````````````````````````````````````[`````[`````==`````[`````[``````````````````=``==``[```=```[```=```=```=```=
=````````````````````````````````````````````=```=``````````````=```=```````````````````=``==``=```[```=```=```=```=```=
=`````````````````````````````````````````````=[[=``````[[``````=[[=````````````````````=====[==[=====[==[======[=======
=``````````````````````````````````````````````=``=`````==`````=``=`````````````````````=``==``=```=```[```=```[```=```=
=```````````````````````````````````````````````=``=````==````=``=``````````````````````=``==``=```[```=```[```=```=```=
=````````````````````````````````````````````````=``=```==```=``=```````````````````````======[=======[=[====[==[===[===
=`````````````````````````````````````````````````=``=``==``=``=````````````````````````=``==``=```=```=```[```=```=```=
=``````````````````````````````````````````````````=$$======%%=`````````````````````````=``[[``[```[```[```=```[```[`D`=
========================================================================================================================
=`````````````=`````````````````````````````````````````==```````````````````````````````````````````````=`````````````=
=````````````=``````````````````````````````````````````==````````````````````````````````````````````````=````````````=
=```````````=```````````````````````````````````````````==`````````````````````````````````````````````````=```````````=
=``````````=````````````````````````````````````````````==``````````````````````````````````````````````````=``````````=
=`````````=`````````````````````````````````````````````==```````````````````````````````````````````````````=`````````=
=````````=``````````````````````````````````````````````==````````````````````````````````````````````````````=````````=
=```````=```````````````````````````````````````````````[[`````````````````````````````````````````````````````=```````=
=``````=````````````````````````````````````````````````==``````````````````````````````````````````````````````=``````=
=`````=`````````````````````````````````````````````````==```````````````````````````````````````````````````````=`````=
=````=``````````````````````````````````````````````````==````````````````````````````````````````````````````````=````=
=```=```````````````````````````````````````````````````==`````````````````````````````````````````````````````````=```=
=``=````````````````````````````````````````````````````==``````````````````````````````````````````````````````````=``=
=`=`````````````````````````````````````````````````````==```````````````````````````````````````````````````````````=`=
==``````````````````````````````````````````````````````[[````````````````````````````````````````````````````````````==
========================================================[[==============================================================
```````````````````````````````````````````````````````=``=`````````````````````````````````````````````````````````````
```````````````````````````````````````````````````````=``=`````````````````````````````````````````````````````````````
`=======================================================[[=============================================================`
`=````````````````````````````````````````````````````````````````````````````````````````````````````````````````````=`
`=````````````````````````````````````````````````````````````````````````````````````````````````````````````````````=`
`======================================================================================================================`
