========================================================================================================================
==````[````=````=````=````=````=````=````=````=````=````[[````=````=````=`````=````[````=````=````=````=````=````[````==
=`=````=````=````=````=````[````=````=````=````[````=```==```=````=````=`````=````=````=````=````=````=````=````=````=`=
=``=````=````=````=````=````=````=````=````=````=````[``==``[````=````=`````=````=````=````=````=````=````=````=````=``=
=```=````=````=````=````=````=````=````[````=````=````=$==$=````=````[`````=````=````=````=````=````[````=````=````=```=
=````=````=````=````[````=````=````=````=````=````=````====````=````=`````=````=````=````=````=````=````=````=````=````=
==````=````=````=````=````=````=````=````=````=````=````==````=````=`````=````=````=````=````=````=````=````=````=````==
=`=````=````=````=````=````=````=````=````=````=````=```==```=````=`````=````=````=````[````=````=````=````=````=````=`=
=``=````=````=````=````=````=````=````=````=````=````=``[[``=````=`````[````=````=````=````=````=````=````=````=````=``=
=```=````=````=````=````=````=````=````=````=````=````=`==`[````=`````=````=````=````=````=````=````=````=````=````=```=
=````=````=````=````=````=````=````=````[````=````=````====````=`````=````=````=````=````=````=````=````=````=````=````=
=`````=````[````=````=````=````=````=````=````=````=````==````=`````=````=````=````=````[````=````=````=````[````=`````=
=``````=````=````=````=````=````=````=````=````=````=```==```=`````=````=````=````=````=````=````=````=````=````=``````=
========[=====`~~~=````[````=````=````=````=````=````[``==``=`````=````=````=````=````=````=````[````=````=====[========
=~~~~~~=``````=$$$$=````=````=````[````=````=````=````=`==`=`````=````=````[````=````=````=````=````=`%$`=``````=~~~~~~=
========```````======````=````=````=````=````=````=````====`````=````=````=````=````=````=````=````======```````========
==============[=========================================================================================================
=`````````````````````````````````````````````````[```$====%```[````````````````````````=``==``==``[```=```[```=```[```=
=``````````````````````````````````````````````````=``=`==`=``=`````````````````````````=``[[``==``=```=```=```=```=```=
=```````````````````````````````````````````````````==``==``==``````````````````````````=``==``==``=```[```=```[```=```=
=```````````````````````````````````````````````````=```==```=``````````````````````````=``===[===========[===[=========
=``````````````````````````````````````````````````=````==````=`````````````````````````=``[[``==``=```[```=```=```[```=
=`````````````````````````````````````````````````=`````[[`````=````````````````````````=``==``[[``[```=```[```[```=```=
=````````````````````````````````````````````````=``````[[``````=```````````````````````=``==========[===[=======[==[===
=```````````````````````````````````````````````=```````==```````=``````````````````````[``[[``==``=```[```[```[```=```=
=``````````````````````````````````````````````=````````==````````=`````````````````````=``==``==``[```=```=```=```[```=
=`````````````````````````````````````````````[`````````==`````````[````````````````````=``======[=======[===[===[====[=
=````````````````````````````````````````````=``````````==``````````=```````````````````=``==``==``=```=```[```=```=```=
=```````````````````````````````````````````=```````````==```````````=``````````````````=``==``==``[```=```=```=```=```=
======================================================[====[==========================================[==[===[==========
=```````````````````````````````````````````[`````[`````==`````[`````[``````````````````=``==``[```=```[```=```=```=```=
=````````````````````````````````````````````=```=``````````````=```=```````````````````=``==``=```[```=```=```=```=```=
=`````````````````````````````````````````````=[[=``````[[``````=[[=````````````````````=====[==[=====[==[======[=======
=``````````````````````````````````````````````=``=`````==`````=``=`````````````````````=``==``=```=```[```=```[```=```=
=```````````````````````````````````````````````=``=````==````=``=``````````````````````=``==``=```[```=```[```=```=```=
=````````````````````````````````````````````````=``=```==```=``=```````````````````````======[=======[=[====[==[===[===
=`````````````````````````````````````````````````=``=``==``=``=````````````````````````=``==``=```=```=```[```=```=```=
=``````````````````````````````````````````````````=$$======%%=`````````````````````````=``[[``[```[```[```=```[```[`D`=
========================================================================================================================
========```````======````=````=`````````````````````````==`````````````````````````````````````````======```````========
=~~~~~~=``````=`%$`=````=````=``````````````````````````==``````````````````````````````````````````=$$$$=``````=~~~~~~=
========[=====`~~~=````=````=```````````````````````````==```````````````````````````````````````````=~~~`=====[========
=``````=````=````=````=````=````````````````````````````==````````````````````````````````````````````=````=````=``````=
=`````=````=````=````=````=`````````````````````````````==`````````````````````````````````````````````=````=````=`````=
=````=````=````=````=````=``````````````````````````````==``````````````````````````````````````````````=````=````=````=
=```=````=````=````=````=```````````````````````````````[[```````````````````````````````````````````````=````=````=```=
=``=````=````=````=````=````````````````````````````````==````````````````````````````````````````````````=````=````=``=
=`=````=````=````=````=`````````````````````````````````==`````````````````````````````````````````````````=````=````=`=
==````=````=````=````=``````````````````````````````````==``````````````````````````````````````````````````=````=````==
=````=````=````=````=```````````````````````````````````==```````````````````````````````````````````````````=````=````=
=```=````=````=````=````````````````````````````````````==````````````````````````````````````````````````````=````=```=
=``=````=````=````=`````````````````````````````````````==`````````````````````````````````````````````````````=````=``=
=`=````=````=````=``````````````````````````````````````[[``````````````````````````````````````````````````````=````=`=
========================================================[[==============================================================
```````````````````````````````````````````````````````=``=````````````````````````````````````````````````````````````=
```````````````````````````````````````````````````````=``=````````````````````````````````````````````````````````````=
`=======================================================[[==============================================================
`=`=`=`=`=`=`=`=`=`=`=`=`=`=`=`=`=`=`=`=`=`=`=`=`=`=`=`=``=`=`=`=`=`=`=`=``````````````````````````````````````````````=
`=`=`=`=`=`=`=`=`=`=`=`=`=`=`=`=`=`=`=`=`=`=`=`=`=`=`=`=``=`=`=`=`=`=`=`=``````````````````````````````````````````````=
`=======================================================================================================================
