````````````````````````````````````````````````````````````````````````````````````````````````````````````````````````
````````````````````````````````````````==================``````````````````````````````````````````````````````````````
````````````````````````````````````````=```=``$``=``````=``````==========``````````````````````````````````````````````
````````````````````````````````````````=```=`````=``````=``````=```=````=``````````````````````````````````````````````
````````````````````````````````````````=```=`````=``````=``````=```=``U==``````````````````````````````````````````````
````````````````````````````````````````=```===[===``````=``````=$``=````=========``````````````````````````````````````
````````````````````````````````````````=```````=````````=``````=```=````=````````=`````````````````````````````````````
`````````````````````````````````========```````[````````========```=````[`````````=````````````````````````````````````
`````````````````````````````````=``$$``=```````=````````=``````===[=[====``````````=```````````````````````````````````
`````````````````````````````````=``````=```````=````````[``````=```$````=====[[======``````````````````````````````````
`````````````````````````````````===[=======[========[===========`````````=``````````=``````````````````````````````````
`````````````````````````````````=``````[```````=````````[``~~``[````````~[~`````````=``````````````````````````````````
```````````````````````````=========[====```````[````````========````````~[~`````````=``````````````````````````````````
```````````````````````````=````````````=```````=````````[!!!!!$=`````````=``````````=``````````````````````````````````
```````````````````````````=````````````=`````=======================[[=========[=====``````````````````````````````````
`````````````=================================``````=```````````=`````````=````~~~```=``````````````````````````````````
`````````````=``````````=```````=```````````=```````[```````````=`````````======[=====``````````````````````````````````
`````````````=$`````````[```````[``````````=````````=``````$````[`````````=````~~~```=``````````````````````````````````
`````````````============```$```=`````=====================================``````````=``````````````````````````````````
`````````````=````=`````===============`````[```````[`````````````````````[``````````=``````````````````````````````````
`````````````=````=`````[`````=```````=````================================``````````=``````````````````````````````````
`````````````=````=`````=`````[```````=````=```$$```=``````$````[```$$$```=``````````=``````````````````````````````````
````````````======================[====````=````````[```````````=`````````======[=====``````````````````````````````````
````````````=!`````[``=``=````=```````==[[==````````=```````````=`````````=``````````===========````````````````````````
````````````========``[``[````=========````====[[================`````````=``````````=`````````=````````````````````````
````````````========``[``[````[````````````[```````````[,,~~~~,,=====[=====``````````[`````````=````````````````````````
````````````=$`````[``=``=````===[======================!!!~~!!!=`````````=``````````[`````````=````````````````````````
``````````=====[[=============``````=``````[```[```=```=!!^^^^!!=`````````=``````````=`````````=````````````````````````
``````````=``````=`~$=```````=D`````[``````=====```[```=!^AAAA^!=`````````======================````````````````````````
```````````=`````=``~=```````[``````========~~~=```=```=!`^^^^`![`````````=``````=``````[`````$=````````````````````````
````````````=````==[==``$````===[======`$$`=~~~[`=[=====`~~~~~~`=````$````=``````[``````========````````````````````````
`````````````=```````=```````[````````=`~~`=~~~==``````=,,,,,,,,===========``````[``````[``````=````````````````````````
``````````````================````````==[[=========[[======[=====`````````[``````=``````========````````````````````````
`````````````````````````````====[[====``````=`````=````````````=======================````````=````````````````````````
`````````````````````````````=```````[```````[`````[````````````=`````=````=``=```````=````````=````````````````````````
`````````````````````````````=```````=```````=`````[````````````=`````[````=``=```````=````````=````````````````````````
`````````````````````````````============[====`````=````````````=`````=````[``=```````====[[====````````````````````````
```````````````````````=========``````=`````====[[================[======[==``[```````=```````=`````````````````````````
```````````````````````=`!~~```=``````[`````=``````=```=````[`````````=````======[[====``````=``````````````````````````
```````````````````````=`!~~```[``````=`````[``````[```[````=`````````=$```=``````````=`````=```````````````````````````
``````````````````````=``!~~```====[=====[===``$$``=```===========[[====[========[[=========````````````````````````````
`````````````````````=$``!~~```=``````[`````============````````````````=``````[````=```````````````````````````````````
````````````````````============``````=`````=````````[``````````````````=``````[````=```````````````````````````````````
````````````````````````````````=======[=====````````=====[===========[==============```````````````````````````````````
`````````````````````````````````=~~~~~~~~~~~=====[=======````````=````````=````````=```````````````````````````````````
``````````````````````````````````=``````````=````````=````$$````=````~~```[``````$=````````````````````````````````````
```````````````````````````````````===============[================================`````````````````````````````````````
```````````````````````````````````````````````=$```$=``````````````````````````````````````````````````````````````````
```````````````````````````````````````````````=======``````````````````````````````````````````````````````````````````
````````````````````````````````````````````````````````````````````````````````````````````````````````````````````````
````````````````````````````````````````````````````````````````````````````````````````````````````````````````````````
````````````````````````````````````````````````````````````````````````````````````````````````````````````````````````
````````````````````````````````````````````````````````````````````````````````````````````````````````````````````````
````````````````````````````````````````````````````````````````````````````````````````````````````````````````````````
````````````````````````````````````````````````````````````````````````````````````````````````````````````````````````