````````````````````````````````````````````````````````````````````````````````````````````````````````````````````````
````````````````````````````````````````==================``````````````````````````````````````````````````````````````
````````````````````````````````````````=```=``$``=``````=``````==========``````````````````````````````````````````````
````````````````````````````````````````=```=`````=``````=``````=````````=``````````````````````````````````````````````
````````````````````````````````````````=```=`````=``````=``````=````U```=``````````````````````````````````````````````
````````````````````````````````````````=```===[===``````=``````=$```````=========``````````````````````````````````````
````````````````````````````````````````=````````````````=``````=````````=````````=`````````````````````````````````````
`````````````````````````````````========````````````````========````````[`````````=````````````````````````````````````
`````````````````````````````````=``````````````````````````````==========``````````=```````````````````````````````````
`````````````````````````````````=```````````````````````````````````````=====[[======``````````````````````````````````
`````````````````````````````````=```````````````````````````````````````````````````=``````````````````````````````````
`````````````````````````````````=```````````````````````````````````````````````````=``````````````````````````````````
```````````````````````````=======```````````````````````````````````````````````````=``````````````````````````````````
```````````````````````````=`````````````````````````````````````````````````````````=``````````````````````````````````
```````````````````````````=````````````````````````=============````````````````````=``````````````````````````````````
`````````````===============````````````````````````=```````````=````````````````````=``````````````````````````````````
`````````````=``````````=```````````````````````````[```````````=`````````============``````````````````````````````````
`````````````=$`````````[```````````````````````````=``````$````[`````````=``````````=``````````````````````````````````
`````````````============`````````````=====================================``````````=``````````````````````````````````
`````````````=````=`````=`````````````=`````[```````[`````````````````````[``````````=``````````````````````````````````
`````````````=````=`````[`````````````=````================================``````````=``````````````````````````````````
`````````````=````=`````=`````````````=````=````````=``````$````[`````````=``````````=``````````````````````````````````
````````````===================```````=````=````````[```````````=`````````======[=====``````````````````````````````````
````````````=``````[``=``=````=```````==[[==````````=```````````=````````````````````===========````````````````````````
````````````=``````=``[``[````=========````=````````=============```````````````````````````````````````````````````````
````````````=$`````=``[``[````[````````````=````````````````````````````````````````````````````````````````````````````
````````````=``````[``=``=````==============````````````````````````````````````````````````````````````````````````````
````````````===[[==============`````````````````````````````````````````````````````````````````````````````````````````
`````````````````````=``````````````````````````````````````````````````````````````````````````````````````````````````
`````````````````````=``````````````````````````````````````````````````````````````````````````````````````````````````
`````````````````````=``$`D`````````````````````````````````````````````````````````````````````````````````````````````
`````````````````````=``````````````````````````````````````````````````````````````````````````````````````````````````
`````````````````````=========``````````````````````````````````````````````````````````````````````````````````````````
`````````````````````````````=``````````````````````````````````````````````````````````````````````````````````````````
`````````````````````````````=``````````````````````````````````````````````````````````````````````````````````````````
`````````````````````````````=``````````````````````````````````````````````````````````````````````````````````````````
`````````````````````````````=``````````````````````````````````````````````````````````````````````````````````````````
```````````````````````=========````````````````````````````````````````````````````````````````````````````````````````
```````````````````````=`!~~```=````````````````````````````````````````````````````````````````````````````````````````
```````````````````````=`!~~```[````````````````````````````````````````````````````````````````````````````````````````
``````````````````````=``!~~```=````````````````````````````````````````````````````````````````````````````````````````
`````````````````````=$``!~~```=````````````````````````````````````````````````````````````````````````````````````````
````````````````````============````````````````````````````````````````````````````````````````````````````````````````
````````````````````````````````=======[========`````=====[=========````````````````````````````````````````````````````
`````````````````````````````````=~~~~~~~~~~~=====[=======````````=`````````````````````````````````````````````````````
``````````````````````````````````=``````````=````````=````$$````=``````````````````````````````````````````````````````
```````````````````````````````````===============[==============```````````````````````````````````````````````````````
```````````````````````````````````````````````=$```$=``````````````````````````````````````````````````````````````````
```````````````````````````````````````````````=======``````````````````````````````````````````````````````````````````
````````````````````````````````````````````````````````````````````````````````````````````````````````````````````````
````````````````````````````````````````````````````````````````````````````````````````````````````````````````````````
````````````````````````````````````````````````````````````````````````````````````````````````````````````````````````
````````````````````````````````````````````````````````````````````````````````````````````````````````````````````````
````````````````````````````````````````````````````````````````````````````````````````````````````````````````````````
````````````````````````````````````````````````````````````````````````````````````````````````````````````````````````