````````````````````````````````````````````````````````````````````````````````````````````````````````````````````````
````````````````````````````````````````````````````````````````````````````````````````````````````````````````````````
````````````````````````````````````````````````````````````````````````````````````````````````````````````````````````
````````````````````````````````````````````````````````````````````````````````````````````````````````````````````````
``````==========================================================================================================````````
``````============````=`````=```````````=``````````````````````````````````````````````````````````````````````=````````
``````=``=```````[````==[====```````````=``````````````````````````````````````````````````````````````````````=````````
``````=```=[==```=``````````[```````````=``````````````````````````````````````````````````````````````````````=````````
``````=``````=====`````======```````````=``````````````````````````````````````````````````````````````````````=````````
``````=``````````=`````[````=```````````=``````````````````````````````````````````````````````````````````````=````````
``````=====[=========[=============[=====``````````````````````````````````````````````````````````````````````=````````
``````=``````````=``````````=```````````=``````````````````````````````````````````````````````````````````````=````````
``````=``````````=``````````[```````````=``````````````````````````````````````````````````````````````````````=````````
``````=``````````=``````````=```````````=``````````````````````````````````````````````````````````````````````=````````
``````=``````````=``````````=```````````=``````````````````````````````````````````````````````````````````````=````````
``````=====[=============================``````````````````````````````````````````````````````````````````````=````````
``````=````````=````=````=````````[``$``=======================================````````````````````````````````=````````
``````=````````[````=````=````````=`````=````=````````=`````=````=````````````=````````````````````````````````=````````
``````=````````[````==[[==````````=======````=````````=`````=````=`,,,,,,,,,,`=````````````````````````````````=````````
``````=````````=``````````````````[````$==[===````````[`````==[===`,~~~~~~~~,`=````````````````````````````````=````````
``````=================[[================`````````````=``````````=`,~~~~~~~~,`=````````````````````````````````=````````
``````=``````=````````````````=`````````=======[==================`,~~~#~~~~,`=````````````````````````````````=````````
``````=``````[````````````````[`````````=````````=`%%`[````=`````=`,~~~#~~~~,`=````````````````````````````````=````````
``````==========[==============`````````=````````[````=````=`````=`,,,,,,,,,,`=````````````````````````````````=````````
``````=``````[````````````````[`````````=````````=======[===`````=````````````=````````````````````````````````=````````
``````=``````=````````````````=`````````[`````````````=``````````=````````````=````````````````````````````````=````````
``````==================================================================[======````````````````````````````````=````````
``````=`,!!!,,``=`````=`````===================````````````````````````````````````````````````````````````````=````````
``````=`````````=`````[`````=D,[``%`````=````$====================`````````````````````````````````````````````=````````
``````=====[=====`````=======,,=````````[``````````=`````````````=`````````````````````````````````````````````=````````
``````=`````````===[===`````==========[==``````````[`````````````=`````````````````````````````````````````````=````````
``````=`````````=`````[`````=```=`$$=```============`````````````=`````````````````````````````````````````````=````````
``````======````===========`[```=[===```=``````````=======[[======`````````````````````````````````````````````=````````
``````=````[`````=```$````=`[```````````[``````````=```````````````````````````````````````````````````````````=````````
``````=````=`````[````````=`=```````````=``````````=```````````````````````````````````````````````````````````=````````
``````==================[===========================```````````````````````````````````````````````````````````=````````
``````=````=```=``````=```````[`````=``````````````````````````````````````````````````````````````````````````=````````
``````=````[````[`````=````````=```[`=======```````````````````````````````````````````````````````````````````=````````
``````=````=````==````====[[=====`=````````=```````````````````````````````````````````````````````````````````=````````
``````========[==`=```=``````````===========```````````````````````````````````````````````````````````````````=````````
``````=````````````=``=`````````=``````````````````````````````````````````````````````````````````````````````=````````
``````==================[=======```````````````````````````````````````````````````````````````````````````````=````````
``````=````````````````=`=``````````````````===========````````````````````````````````````````````````````````=````````
``````=``````````=======`=``````````````````=$```````%=````````````````````````````````````````````````````````=````````
``````=``````````=$````[`=``````````````````=====`=====````````````````````````````````````````````````````````=````````
``````=```````````=%```=`=``````````````````````=`=````````````````````````````````````````````````````````````=````````
``````=````````````=%``=[=``````````````````````=`=````````````````````````````````````````````````````````````=````````
``````=`````````````====`========================[=========````````````````````````````````````````````````````=````````
``````=````````````````=`[````````````````````````````````=````````````````````````````````````````````````````=````````
``````=````````````````=`==============================```=````````````````````````````````````````````````````=````````
``````==================[==============================[[[======================================================````````
``````=```````````````=```=```````````````````````````````=```````=````[```````````````````````````````````````=````````
``````=```````````````==[==```````````````````````````````[```````==[===========================================````````
``````=```````````````````````````````````````````````````[````````````=========================================````````
``````=```````````````````````````````````````````````````=````````````[```````````````````````````````````````=````````
``````==========================================================================================================````````
````````````````````````````````````````````````````````````````````````````````````````````````````````````````````````
````````````````````````````````````````````````````````````````````````````````````````````````````````````````````````
````````````````````````````````````````````````````````````````````````````````````````````````````````````````````````
````````````````````````````````````````````````````````````````````````````````````````````````````````````````````````
